Adiutori - American Fiction And Mass Culture
Ansari - American Fiction And Mass Culture|Foundationz Of Electromagnetism And Modern Physics|Structural Analysis
Archias - Collections And Visual Knowledge In Early Modern Europe|Intro To Modernism Past Future Exile Home
Bailey - Introduction To Science And Society Theories And Controversies|Operating Systems
Bassiri - Heat And Mass Transfer|Principles Of Ecology
Bell - Art After India|Photolab The Visual Performance Of Rights|Software Engineering
Bergerwolf - Advanced Probabilistic Methods In Computer Science|Algorithms For Big Data|Architecture Of The House Through Space And Time|Biomaterials|Building A Web Application|Computational Methodz For Biology|Introduction To Filmmaking Time And Form|Recent Applications Of Probability And Statistics|Topics In Information Retrieval And Web Search|Writing And Speaking Chineze I
Boy - Hilbert Spaces And Their Applications|Introduction To Filmmaking Time And Form|Narrative And Immersion
Brennan - Astrophysics And Cosmology|Intermediate 3D Computer Animation
Caliskan - Analytic Geometry And Calculus|Electrical Circuits And Signals|Melville Conrad And The Sea|Statistical Mechanics
Checkoway - Computer Systems Security Principles And Practice|Getting Emotional Passionate Theories|Intro To Combinatorial Optimization|Topics In Ecology And Evolutionary Biology
Chudnovsky - Foundationz Of Electromagnetism And Modern Physics|Fracture Mechanics|Intro To Computation For The Humanities And Social Sciences|Topics In Grounded Language For Robotics
Clarno - Chemical Process Design|Intro To Computation For The Humanities And Social Sciences
Cranch - 3D Photography And Geometry Processing
Cui - Computational Theory Of Molecular Evolution|The Postcolonial And The Postmodern
Dai - Introduction Ductory Calculus Part II
Dasgupta - Cultures And Countercultures The American Novel After World War II|Parallel Computation Models Algorithms Limits
Dunn - Introduction Duction To Architectural Design
Eriksson - Computer Graphics Lab|Introduction To Computation For The Humanities And Social Sciences
Eugenio - Computational Physics|Fracture Mechanics|The United States Metropolis
Fink - The Korean War In Color|The Public Intellectual
Fish - 3D Photography And Geometry Processing|Intro To Computation For The Humanities And Social Sciences|Intro To Computer Graphicz|The Foundation Of Living Systems
Forbes - Introductory Biochemistry
Foster - Analytic Geometry And Calculus|Mechanics Of Solids
Furman - Art After India|Distributed Computing Through Combinatorial Topology|Probabilistic Graphical Models|Probabilistic Methods In Computer Science
Gallik - Intro To Computer Graphicz|Molecular Genetics
Gillet - Algebraic Geometry|Analytic Geometry And Calculus|Datadriven Vizion And Graphics|Pompeii Art Architecture And Archaeology In The Lost City|Quantum Mechanics
Gmytrasiewicz - Computational Methodz For Biology|Fundamentals Of Computer Systems|Literary Communities|Topics In Ecology And Evolutionary Biology
Hogan - Computational Theory Of Molecular Evolution|Interdisciplinary Scientific Visualization|Operations Research Probabilistic Models
Hummel - Introduction To Algorithms And Data Structures|Introductory Calculus Part I|Introductory Compiler Construction|Transport And Biotransport Processes
Jin - Advanced Algorithms Seminar|Hilbert Spaces And Their Applications
Johnson - Cell And Molecular Biology|Computer Aided Visualization And Design
Jones - Building Intelligent Robots|Filtering And Prediction Of Hidden Markov Models|Partial Differential Equationz|The Literary Scholar
Kanich - Accelerated Introduction To Computer Science|Computer Networks|Nineteenthcentury British Novel
Kenyon - Human Factors And User Interface Design
Krall - Nature And Law In American Literature|Nineteenthcentury British Novel|The Postcolonial And The Postmodern
Kshemkalyani - Filtering And Prediction Of Hidden Markov Models|Introductory Calculus Part I|Parallel Computation Models Algorithms Limits
Lekili - Filtering And Prediction Of Hidden Markov Models|Introductory Calculus Part I
Lillis - Advanced Programming For Digital Art And Literature|Coding The Matrix Linear Algebra Through Computer Science Applicationz|Educational Software Seminar|Intro To Computation For The Humanities And Social Sciences|Parallel And Distributed Programming
Lu - Biomaterials|Computational Fluid Dynamics|Crossing The Consumer Chasm By Design|Innovation And Technology Management II|Models Of Computation|Pattern Recognition And Machine Learning|Temporalitiez|The Literary Scholar|Writing And Speaking Chineze I
Lyons - Cultures And Countercultures The American Novel After World War II|Humancomputer Interaction Seminar|Internet And Web Algorithms|Intro To Sceintific Computing|Reinventionz Of Life Aesthetics Biopolitics And The Avantgardes|Writing And Speaking German I
Marai - 2D Game Engines|Temporalitiez
Metlushko - Mathematical Statistics|Melville Conrad And The Sea|Stem Cell Engineering|Womens Voices In Medieval Literature
Mojab - Individual Independent Study|Intro To Power Engineering
Ozevin - Fundamentals Of Computer Systems|Honors Linear Algebra|Intro To Scientific Computing And Problem Solving|Transport And Biotransport Processes
Rao - Collections And Visual Knowledge In Early Modern Europe|Combinatorial Topology|Independent Study In 2D Game Engines|Touring The Empire Travel Literature And The Idea Of America
Reddy - Altered States|Quantum Mechanics|Reinventionz Of Life Aesthetics Biopolitics And The Avantgardes
Reed - Introduction To Discrete Structures And Probability|Thermodynamics
Sauerwald - American Poetry II Modernism|Computer Systems Security Principles And Practice|Computer Vizion|Pattern Recognition And Machine Learning|Talking With Computers|The Postcolonial And The Postmodern|Topics In Information Retrieval And Web Search|Writing And Speaking Chineze I
Savar - Computational Topology|Fieldwork In The Urban Community|Intellectual Life And Culture In The Postwestern World
Shonfeld - Computer Aided Visualization And Design|Heat And Mass Transfer|Medical Bioinformatics
Siber - 3D Photography|Cell And Molecular Biology|Reading And Research
Sinapova - Intro To Computational Geometry|The Claims Of Fiction
Sistla - Algorithmic Foundations Of Computational Biology|Database Management Systems|Dynamics And Vibrations|El Greco And Velazquez|Intro To Computer Graphicz|Intro To Power Engineering|Molecular Genetics|Pompeii Art Architecture And Archaeology In The Lost City
Sloan - Introduction Duction To Computational Linguistics
Soheili - Biophysical And Bioinorganic Chemistry|Shakespeare
Solworth - Intro To Computation For The Humanities And Social Sciences|Mechanics Of Solids|Nineteenthcentury Architecture
Tafti - Advanced Programming For Digital Art And Literature|Introduction To Scientific Computing|Managerial Decision Making|Recent Applications Of Probability And Statistics|The Design And Analysis Of Trading Agents|Topics In Data Science|Topics In Gametheoretic Artificial Intelligence
Taylor - Biophysical And Bioinorganic Chemistry|The Aesthetics Of Color History Theory Critique
Theys - Cinematic Coding And Narrativity|Distributed Computing Through Combinatorial Topology|Foundationz Of Electromagnetism And Modern Physics|Introduction To Algorithms And Data Structures|Inventing The Past Amulets Heirlooms Monuments Landscapes|Principles Of Ecology|Virtual Citizens Or Subjects The Global Battle Over Governing Your Internet
Troy - Computer Aided Visualization And Design|Introductory Compiler Construction|The Design And Analysis Of Trading Agents
Valbonesi - Computer Vizion
Vamanan - Complex Function Theory|Datadriven Vizion And Graphics|Dynamics And Vibrations
Velebit - Advanced Programming For Digital Art And Literature|Autonomous Agents And Computational Market Design|Reinventionz Of Life Aesthetics Biopolitics And The Avantgardes|Transport And Biotransport Processes
Vinella - Intro To Combinatorial Optimization|Software System Design|Topics In Computer Vision
Walden - Back To The Future Nostalgia And Futurity In Contemporary Scifi Tv And Telefantasy|Environmental History|Hilbert Spaces And Their Applications|Human Factors And User Interface Design|Interdisciplinary Scientific Visualization|Introduction To Systems Programming|Special Topicz In Advanced Algorithms|Topics In 3D Game Engine Development|Topics In Ecology And Evolutionary Biology
Westland - Introductory Calculus Part I|Melville Conrad And The Sea|Narrative And Immersion|Probabilistic Graphical Models|Projects In Engineering Design|Victorian Inequality
Wolak - American Fiction And Mass Culture|Descartes World
Wolfson - Database Management Systems|Datadriven Vizion And Graphics
Yu - Altered States|Applied Artifical Intelligence|Computers And Human Values|Special Topicz In Advanced Algorithms
Ziebart - Intro To Number Theory|Machine Learning Reading Group
Zuck - Basic Physics|Statistical Inference II
